15
====================
=   K              =
=                  =
= !                =
==========       M =
=  W        T      =
=                  =
=    *      ========
=   *X*            =
=    *             =
=                  =
=========   	   =
=           ========
=       X        @ =
====================

1 4
4 17
5 3
5 12
1
3 5 19 6
1 14 