12
======================
=   K                =
=        =           =
= !      =           =
==========         M =
=  W     =  T        =
=        =           =
=    *        ========
=                    =
=             ========
=      X  #  @       =
======================

1 4
4 19
5 3
5 12
1
3 5 19 6
1 14 