15
====================
=   K              =
=                  =
= !                =
==========       M =
=  W        T      =
=                  =
=    *      ========
=   *X*            =
=	 *			   =
=				   =
=========   	   =
=			========
=		X	#	 @ =
====================

1 5
4 18
5 4
5 13
1
3 5 19 6
1 14 