10 
==========
=  =  #  =
=  K  M  =
=  *    !=
= W      =
=   @  X =
=        =
=  X     =
=     T  =
==========

1 3
2 6
4 2
8 6
1
5 7 7 3


